NO ./texture/north.xpm
SO ./texture/south.xpm
WE ./texture/west.xpm
EA ./texture/east.xpm

F 96,96,96
C 224,224,1

111111111111111111111111111111111111111111111111
100000000000000000000000000000000000000000000001
100000000000000000000000000000000000000000000001
100000000000000000000000000000000000000000000001
100000000000000000000000000000000000000000000001
100000000000000000000000000000000000000000000001
100000111111111111111111111111111111110111111111
100000100000000000000000000010000000000000000001
100000100000000000000000000010000000000000000001
100000100000000000000000000010000000000000000001
100000100000000000000000000010000000000000000001
100000100000000000000000000010000000000000000001
100000100000000000000000000010000000000000000001
100000100000000000000000000010111111111111111111
100000000000000000000000000000000100000000000001
100000100000000000111111110110000000000000000001
100000100000000000100000000010011100000000000001
100000100000000000111111111110000100000000000001
100000100000000000100000000010011100000000000001
100000100000000000100000000010000100000000000001
100000100000000000100000000010011111100000000001
100000100000000000100000000010000000100000000001
100000100000000000100000000010011111100000000001
100000100000000000100000000010000000111111111111
100000100000000000100000000010011100000000000001
100000100000000000100000000010011100000000000001
100000100000000000111111111110001100000000000001
10000010000000000010000E000000001000000000000001
100000100000000000111111111110001000000000000001
100000100000000000100000000010001000000000000001
100000100000000000100000000010111000000000000001
100000100000000000100000000010101000000000000001
100000100000000000111111111110100000000000000001
100000100000000000000001000000000000000000000001
100000100000000000111111111110000000000000000001
100000100000000000000000000000000000000000000001
100000111000111101111011110110000000000000000001
100000100000001000100001000010000000000000000001
100000100000001000100001000010000000000000000001
111111111111111111111111111111111111111111111111