NO ./texture/north.xpm
SO ./texture/south.xpm
WE ./texture/west.xpm
EA ./texture/east.xpm                 

F 20,10,241
C 20,190,00

1111111111111111111111
1101111100011111111111
1111111101011111111111
10000000000000S0000001
1000000000000000000001
1111111111111111111111