NO ./texture/north.xpm
SO ./texture/south.xpm
WE ./texture/west.xpm
EA ./texture/east.xpm
F 220,100,0
C 225,30,0
111111111111111111
100000000000000001
100000000000000001
100000000000000001
100000000000000001
10000000000000N001
111111111111111111ccccccccccccccc
