NO ./texture/north.xpm

SO ./texture/south.xpm

WE ./texture/west.xpm

EA ./texture/east.xpm                 

F 244,164,1

C 198,226,255


        11111
1101111101111111111111
1111111101011111111111
        1000000E0000001
1111111110000000000001
1111111111111111111111