NO ./texture/north.xpm
SO ./texture/south.xpm
WE ./texture/west.xpm
EA ./texture/east.xpm                 

F 20,10,241
C 20,190,00





1


      1111111111111111111111
111111110111111111111
10000000000000N0000001
1000000000000000000001
1111111111111111111111