NO ./texture/north.xpm
SO ./texture/south.xpm
WE ./texture/west.xpm
EA ./texture/east.xpm

F 96,96,96
C 224,224,1

 1111
1N0001
 1111