NO ./texture/north.xpm
NO ./texture/north.xpm
SO        ./texture/south.xpm



WE ./texture/west.xpm
EA ./texture/east.xpm                 

F 244,164,4294967304
C 198,226,255

11111
10001
10001
10001
10001
10001
10001
10001
10001
10001
10001  1 
10001 1N1
10001  1
10001
10001
10001
10001
10001
10001
10001
10001
10001
10001
10001
10001
10001
10001
10001
10001
10001
10001
10001
10001
10001
10001
10001
10001
10001
10001
10001
10001
10001
10001
10001
10001
10001
10001
10001
10001
10001
10001
10001
10001
10001
10001
10001
10001
10001
10001
10001
10001
10001
10001
10001
10001
10001
10001
10001
10001
10001
10001
10001
10001
10001
10001
10001
10001
10001
10001
10001
10001
10001
10001
10001
10001
10001
10001
10001
10001
10001
10001
10001
10001
10001
10001
10001
10001
10001
10001
10001
10001
10001
10001
10001
10001
10001
10001
10001
10001
10001
10001
10001
10W01
11111