NO ./texture/north.xpm
SO ./texture/south.xpm
WE ./texture/west.xpm
EA ./texture/east.xpm
C 1,200,3
F     255,255,255









        1111111111111111111111111
        1000000000110000000000001
        1011000001110000000000001
        1001000000000000000000001
111111111111111111111111111111111
100000000011000001110111111111111
11110111111111011100000010001
11110111111111011101010010001   111111
11000000110101011100000010001   100000
10000000000000001100000010001   111111
10000000000000001101010010001
1100000111010101111101111000111
1111111111111111111111111101111

11111111111111111111111111111
100000000000000000S0000000001
11111111111111111111111111111
11111111 1110111 101111111111