NO ./texture/north.xpm
SO ./texture/south.xpm
WE ./texture/west.xpm
EA ./texture/east.xpm

F 220,100,0
C 224,30,0

        1111111111111111111111111
        1000000000110000000010001
        101100000111000000010001
        1001000000100000000010001
111111111111111111111111111111111
100000000011000001110111111111111
11110111111111011100000010001
11111111111111011101010010001   111111
11000000110101011100000010001   100001
1000E000000000001100000010001   111111
1000000000000001101010010001
1100000111010101111101111000111
11110111 1110101 101111010001
11111011 1111111 101111111111